WWWWWWWWWWWWWWWWWWWW
WPPPPPPPPPPPPPPPPPPW
WPPPPPPWWWWWWPPPPPPW
WPPEPPPPPPPPPPPPEPPW
WPPPWPPPPPPPPPPWPPPW
WPPPWPPPPPPPPPPWPPPW
WPPEPPPPPPPPPPPPEPPW
WPPPPPPPPPPPPPPPPPPW
WPPPPPPPWWWWPPPPPPPW
WPPPPPPPPPPPPPPPPPPW
WWWWWWWWWWWWWWWWWWWW