WWWWWWWWWWWWWWWWWWWW
WPPPPEPPPPPPPPEPPPPW
WPPWWWWWWWWWWWWWWPPW
WPPPPPPPPPPPPPPPPPPW
WPPPPPPPPWWPPPPPPPPW
WPPPPPPPWWWWPPPPPPPW
WPPPPPPPPWWPPPPPPPPW
WPPPPPPPPPPPPPPPPPPW
WPPWWWWWWWWWWWWWWPPW
WPPPPEPPPPPPPPEPPPPW
WWWWWWWWWWWWWWWWWWWW