WWWWWWWWWDDWWWWWWWWW
WPPPPPPPPPPPPPPPPPPW
WPPPPPPPPPPPPPPPPPPW
WPPEPPPPWWWWPPPPEPPW
DPPPWPPPPPPPPPPWPPPD
DPPPWPPPPPPPPPPWPPPD
WPPEPPPPWWWWPPPPEPPW
WPPPPPPPPPPPPPPPPPPW
WPPPPPPPPPPPPPPPPPPW
WWWWWWWWWDDWWWWWWWWW