WWWWWWWWWWWWWWWWWWWW
WPPPPEPPPPPPPPEPPPPW
WPPPPPPPPPPPPPPPPPPW
WPPWPPPPPPPPPPPPWPPW
WPPWPPPPPPPPPPPPWPPW
WPPWPPPPPPPPPPPPWPPW
WPPWPPPPPPPPPPPPWPPW
WPPWPPPPPPPPPPPPWPPW
WPPPPPPPPPPPPPPPPPPW
WPPPPEPPPPPPPPEPPPPW
WWWWWWWWWWWWWWWWWWWW