WWWWWWWWWWWWWWWWWWWWWWWWWWWWWWWWWWWWWWWW
WPPPPPPPPPPPPPPPPPPPPPPPPPPPPPPPPPPPPPPW
WPPPPPPPPPPPPPPPPPPPPPPPPPPPPPPPPPPPPPPW
WPPPPPPPPPPPPPPPPPPPPPPPPPPPPPPPPPPPPPPW
WPPPWPPPPPPPPPPPPPPPPPPPPPPPPPPPPPPWPPPW
WPPPWPPPPPPPPPPPPPPPPPPPPPPPPPPPPPPWPPPW
WPPPWPPPPPPPPPPPPPPPPPPPPPPPPPPPPPPWPPPW
WPPPWPPPPPPPPPPPPPPPPPPPPPPPPPPPPPPWPPPW
WPPPWPPPPPPPPPPPPPPPPPPPPPPPPPPPPPPWPPPW
WPPPWPPPPPPPPPPPPPPPPPPPPPPPPPPPPPPWPPPW
WPPPWPPPPPPPPPPPPPPPPPPPPPPPPPPPPPPWPPPW
WPPPWPPPPPPPPPPPPPPPPPPPPPPPPPPPPPPWPPPW
WPPPWPPPPPPPPPPPPPPPPPPPPPPPPPPPPPPWPPPW
WPPPWPPPPPPPPPPPPPPPPPPPPPPPPPPPPPPWPPPW
WPPPWPPPPPPPPPPPPPPPPPPPPPPPPPPPPPPWPPPW
WPPPWPPPPPPPPPPPPPPPPPPPPPPPPPPPPPPWPPPW
WPPPPPPPPPPPPPPPPPPPPPPPPPPPPPPPPPPPPPPW
WPPPPPPPPPPPPPPPPPPPPPPPPPPPPPPPPPPPPPPW
WPPPPPPPPPPPPPPPPPPPPPPPPPPPPPPPPPPPPPPW
WWWWWWWWWWWWWWWWWWWWWWWWWWWWWWWWWWWWWWWW