WWWWWWWWWDDWWWWWWWWW
WPPPPEPPPPPPPPEPPPPW
WPPPPPPPPPPPPPPPPPPW
WPPPPPPPPPPPPPPPPPPW
DPPPPPPPPWWPPPPPPPPD
DPPPPPPPPPPPPPPPPPPD
WPPPPPPPPWWPPPPPPPPW
WPPPPPPPPPPPPPPPPPPW
WPPPPPPPPPPPPPPPPPPW
WWWWWWWWWDDWWWWWWWWW