WWWWWWWWWDDWWWWWWWWW
WPPPPEPPPPPPPPEPPPPW
WPPPPPPPPPPPPPPPPPPW
WPPWPPPPPPPPPPPPWPPW
DPPWPPPPPPPPPPPPWPPD
DPPWPPPPPPPPPPPPWPPD
WPPWPPPPPPPPPPPPWPPW
WPPPPPPPPPPPPPPPPPPW
WPPPPPPPPPPPPPPPPPPW
WWWWWWWWWDDWWWWWWWWW