WWWWWWWWWWWWWWWWWWWWWWWWWWWWWWWWWWWWWWWW
WPPPPPPPPPPPPPPPPPPPPPPPPPPPPPPPPPPPPPPW
WPEPPPPPPPPPPPPPPPPPPPPPPPPPPPPPPPPPPEPW
WPPPPPPPPPPPPPPPPPPPPPPPPPPPPPPPPPPPPPPW
WPPPPPPPPPPPPPPPPPPPPPPPPPPPPPPPPPPPPPPW
WPPPPPPPPPPPPPPPPPPPPPPPPPPPPPPPPPPPPPPW
WPPPPPPPPPPPPPPPPPPPPPPPPPPPPPPPPPPPPPPW
WPPPPPPPPPPPPPPPPPPPPPPPPPPPPPPPPPPPPPPW
WPPPPPPPPPPPPPPPPPPPPPPPPPPPPPPPPPPPPPPW
WPPPPPPPPPPPPPPPPPPPPPPPPPPPPPPPPPPPPPPW
WPEPPPPPPPPPPPPPPPPPPPPPPPPPPPPPPPPPPPPW
WPPPPPPPPPPPPPPPPPPPPPPPPPPPPPPPPPPPPEPW
WPPPPPPPPPPPPPPPPPPPPPPPPPPPPPPPPPPPPPPW
WPPPPPPPPPPPPPPPPPPPPPPPPPPPPPPPPPPPPPPW
WPPPPPPPPPPPPPPPPPPPPPPPPPPPPPPPPPPPPPPW
WPPPPPPPPPPPPPPPPPPPPPPPPPPPPPPPPPPPPPPW
WPPPPPPPPPPPPPPPPPPPPPPPPPPPPPPPPPPPPPPW
WPEPPPPPPPPPPPPPPPPPPPPPPPPPPPPPPPPPPEPW
WPPPPPPPPPPPPPPPPPPPPPPPPPPPPPPPPPPPPPPW
WWWWWWWWWWWWWWWWWWWWWWWWWWWWWWWWWWWWWWWW